############
#         ##
#### #### ##
##      #B##
## ####   ##
## #### ####
## A   #####
############